11111
1S101
10101
10001
11111
